#####################
# # #         #     #
# # # # ##### # # ###
# #   # #     # #   #
# ##### # ##### ### #
# #     #   #   # # #
# # ####### # ### # #
# #   #   # # #   # #
# ### # # # # ### # #
#     # # # #     # #
####### ### ####### #
# #       # #     # #
# # ##### # # ### # #
#   #     # #   #  ?#
# ### ##### ### ### #
#   #           #   =
#####################